3
1 9 9 3 0
2 8 0 4 1
9 9 1 5 1
4 0 9 6 1
5 1 3 7 1
9 2 4 8 1
7 3 9 9 1
8 4 6 9 1
9 5 7 1 1
1
1
1
0
8
0
0
0
0
0
0
0
2
Welcome to the map!