3
1 9 9 3 2
2 8 0 4 7
9 9 1 5 2
4 0 9 6 4
5 1 3 7 9
9 2 4 8 6
7 3 9 9 2
8 4 6 9 4
9 5 7 1 6
0
0
1
0
8
-10
1
2
1
7
0
0
0
0
10
Play nice for 10 turns!